  WWWWW
WWW   W
W*P B W
WWW B*W
W*WWB W
W W * WW
W  GBB*W
W   *  W
WWWWWWWW