  WWWWW
WWW   W
W*PB  W
WWW B*W
W*WWB W
W W * WW
WB GBB*W
W   *  W
WWWWWWWW