__###___###__
_#---#_#---#_
#--#.-#-.#--#
#-$$$.#.$$*-#
#--#.$*$.#--#
_#-.--#--.-#_
__##.$*$.##__
___#-----#___
____#-$-#____
_____#@#_____
______#______